12111111111111111111
10100000100000000001
10101110101000000001
10001010101100000001
11101000000100000001
10101111110100000001
10101010000100000001
10000000111100000001
10101111111000000001
10000000000000000001
10000000000000000001
10000000000000000001
10000000000000000001
10000000002220000001
10000000000000000001
10000000000000000001
10000000000000000001
10000000000000000001
10000000000000000001
11111111111111111111